EUF= countries/Federation.txt
EFR= countries/France.txt
ECA= countries/Catalonia.txt
EPY= countries/Pyrenees.txt
EGE= countries/Germany.txt
EAL= countries/Alps.txt
EIT= countries/Italy.txt
EBO= countries/Bohemia.txt
EIL= countries/Illyria.txt
EGR= countries/Greece.txt
EIR= countries/Ireland.txt
EBR= countries/Brittania.txt
EBA= countries/Baltic.txt
ESK= countries/Scandinavia.txt
KON= countries/Konigsberg.txt
RPR= countries/Poland.txt
RLI= countries/Lithuania.txt
RBE= countries/Belarus.txt
RSL= countries/Slovakia.txt
SHU= countries/Hungary.txt
ALE= countries/Albania.txt
RMO= countries/Montenegro.txt
SNS= countries/Serbia.txt
RNM= countries/Macedonia.txt
RBU= countries/Bulgaria.txt
RST= countries/Romania.txt
RSC= countries/Scothland.txt
RML= countries/Moldova.txt
UNR= countries/Ukraine.txt
KCR= countries/Cuban.txt
NCI= countries/Imamat.txt
RUS= countries/Russia.txt
RFE= countries/Ural.txt
SIB= countries/Siberia.txt
GES= countries/Georgia.txt
ARR= countries/Armenia.txt
AWR= countries/America.txt
AZE= countries/Azerbaijan.txt
MAF= countries/Asia.txt
NOE= countries/Turkey.txt
CNR= countries/China.txt
SKO= countries/Korea.txt
RJA= countries/Japan.txt
IRA= countries/Iran.txt
AFW= countries/Afghanistan.txt
PKS= countries/Pakistan.txt
IQR= countries/Iraq.txt
SIR= countries/Syria.txt
RLV= countries/Livan.txt
IGB= countries/Israel.txt
JRD= countries/Jordan.txt
KWA= countries/Kuwait.txt
SAR= countries/Aravia.txt
YRE= countries/Yemen.txt
ALK= countries/Al-Kaida.txt
SOE= countries/Oman.txt
ARE= countries/Emirate.txt
QTR= countries/Qatar.txt
BGA= countries/India.txt
FDN= countries/Nepal.txt
BNG= countries/Bangladesh.txt
SRI= countries/Sri-Lanka.txt
MRE= countries/Maldives.txt
MNM= countries/Mjanma.txt
SRV= countries/Vietnam.txt
PCA= countries/Cambodia.txt
LND= countries/Laos.txt
KTH= countries/Thailand.txt
SRM= countries/Malazia.txt
RPP= countries/Philipines.txt
RIN= countries/Indonesia.txt
PND= countries/New_Guinea.txt
AUN= countries/Australia.txt
NZA= countries/New_Zeland.txt
ETI= countries/Timor.txt
CAL= countries/Caledonia.txt
RFI= countries/Fidji.txt
SOI= countries/Solomon.txt
ISS= countries/Samoa.txt
PAA= countries/Palau.txt
CNM= countries/Marian.txt
RNA= countries/Nauru.txt
FST= countries/Micronesia.txt
STU= countries/Tuvalu.txt
RKI= countries/Kiribati.txt
EOC= countries/Oceania.txt
CND= countries/Canada.txt
EAT= countries/Atlantic.txt
EOI= countries/Ost-India.txt
EUM= countries/Mexico.txt
RCU= countries/Cuba.txt
SJA= countries/Jamaica.txt
RHA= countries/Haiti.txt
RDO= countries/Dominicana.txt
CSP= countries/Puerto_Rico.txt
BEI= countries/Belize.txt
RGU= countries/Guatemala.txt
RES= countries/Salvador.txt
RHO= countries/Honduras.txt
RNI= countries/Nicaragua.txt
RKO= countries/Costa_Rika.txt
PAD= countries/Panama.txt
CBI= countries/Bahams.txt
AAB= countries/Barbuda.txt
SKN= countries/Sent.txt
SVG= countries/Vinsent.txt
TTT= countries/Trinidad.txt
DJA= "countries/Libyan Jamahiriya.txt"
LRP= "countries/Libyan Republic.txt"
BCL= "countries/Bedouin coalition.txt"
EAF= "countries/Eastern African Federation.txt"
EAR= "countries/Egypt.txt"
RSU= "countries/Sudan.txt"
DAI= "countries/Eritrea.txt"
FRS= "countries/Somalia.txt"
RJI= "countries/Djibouti.txt"
RAM= "countries/Madagascar.txt"
EWR= "countries/Ethiopia.txt"
RUT= "countries/Tunis.txt"
ALD= "countries/Algeria.txt"
KMO= "countries/Morocco.txt"
SAD= "countries/Sahara.txt"
IMA= "countries/Mauritania.txt"
RDM= "countries/Mali.txt"
ENI= "countries/Niger.txt"
RDT= "countries/Chad.txt"
KBA= "countries/Rca.txt"
RDC= "countries/Kameroon.txt"
ECG= "countries/Ecuator.txt"
MBE= "countries/Gabon.txt"
RYK= "countries/Kongo.txt"
OON= "countries/Islamnigeria.txt"
FRN= "countries/Nigeria.txt"
RDD= "countries/Benin.txt"
RBB= "countries/Faso.txt"
RTT= "countries/Togo.txt"
BGB= "countries/Ghana.txt"
KDC= "countries/Cote.txt"
RLF= "countries/Liberia.txt"
RNS= "countries/Leone.txt"
GKR= "countries/Guineaa.txt"
RVG= "countries/Bisau.txt"
RND= "countries/Senegal.txt"
GRR= "countries/Gambia.txt"
RKV= "countries/Verde.txt"
STP= "countries/Santome.txt"
VUF= "countries/Angola.txt"
NRR= "countries/Zambia.txt"
RAB= "countries/Mozambik.txt"
NYZ= "countries/Zimbabwe.txt"
LLB= "countries/Botswana.txt"
OYN= "countries/Namibia.txt"
INA= "countries/Southafrica.txt"
DAR= "countries/Mauricius.txt"
RSI= "countries/Seishel.txt"
FFB= "countries/Brazil.txt"
ROU= "countries/Urugiai.txt"
RDP= "countries/Argentina.txt"
PLZ= "countries/Chilie.txt"
EPB= "countries/Bolivia.txt"
TPA= "countries/Paraguai.txt"
PML= "countries/Peru.txt"
CAD= "countries/Ecuador.txt"
CDJ= "countries/Columbia.txt"
RBV= "countries/Venezuela.txt"
CRG= "countries/Gayana.txt"
RIS= "countries/Surinam.txt"